gggggggggggggggg
g              g
g      *****   g
g     *        g
g     *  *******
g     *        g
g   *****      g
g   *   *****  g
g   *   *      g
g   *   *  ****g
g       *      g
g       *      g
g       *      g
g rrrrrrr      g
g              g
gggggggggggggggg